111111
100011
101001
1100N1
111111